0000000000000000000000000000
0000000000000000000000000000
0000000000000000000000000000
0110000111000000000000110000
0110100000000000000000000000
0111100000000011000000000110
0111100000001100000000000000
0110000100111100001100110000
0000000100111100001100111000
0000111100111111001100111100
1111111100111111001100111100
