111111111111111111111111
100000000000000000000001
100000000000000000000001
100000000000000000000001
100000000000000004000001
100000255225522222220041
100002011111200000000001
100000000000000000000001
120000000000000000000001
100000000000000000000001
100002000000000000000001
100000250050000520000001
120000122222222210000051
100000100000000000001111
100002100000000000000001
100000100000000000000000
10p000100000e00000020003
122222222222222222222222