111111111111111111111111
100000000000000000000001
100000000000000000000001
100000000000000000000001
100000000000000000000001
100000000000000000000001
100000000000000000000001
1p0000000000000000000001
122200000000000000040001
100000000000000000010000
100000005504055000000003
100002222222222220000021
100000000000000000000001
105000000000000000010001
101000000000004000000001
100011000000001111000001
155555500004000555555551
122222222222222222222221