1p0111111111111111111111
100000000000000000000001
100000000000000000000001
100000000000000000000001
122200000000000000000001
100000000000000000000001
100000100000000000000041
155555550001000000000011
122222220000000000000001
100000000005200000000e01
100000000002122222222221
100000000000000000000001
100001000000000000000000
100000000000000000000003
100000000000000000002221
120000000001000000000001
100000000000000e00000001
122222222222222222222221