111111111111111111111111
100000000000000000000001
100000000000000000000001
100000000000000000000001
100000000000000000000001
100000000000000000000001
100000000000000000000000
100000000000000000000003
100000000000000000000222
100000000000000000000001
100000000000000002200001
100000000000004000000001
100000000000022000000001
100000000000000000000001
100000002200000000000001
100000000000000000000001
10p022200000000000000001
122211122222222222222221