111111111111111111111111
100000000000000000000000
100000000000004000000300
100000000000000000001111
100000000000001000000001
100000000000000000000001
100000000001000010000001
100000000000000000000001
100000100000000000000001
100000000000000000000001
100000000000000000000001
100000000022200000000001
100000000000000000000001
100005000040000000000001
100001000010010111100001
100000000000000000000001
10p0000000000000000000e1
122222222222222222222221