111111111111111111111111
100000000000000000000001
100000000000000000000001
100000000000000000000001
100000000000000000000001
100000000000000000000001
10p000000000000000000001
122222000000000000000001
100000000000000000000001
100000022220000000000001
100000000000020000e00001
100000000000012222222221
100e00000200000000000001
122222222100000000000001
100000000000200000000001
100000000000000000000000
10000e00000000000e020003
122222222222222222212222