111111111111111111111111
100000000000000000000000
100000000000000000000300
100000000000000000001111
100000000000000000000001
100000000010100000000001
100000000000000000000001
100200000000000000000001
100000000000000000000001
100000000000000000000001
100000022000000000000001
100000000000000000000001
100000000000220000000001
100000000000000000000001
100001000010010111100001
100000000000000000000001
10p004400000000000000001
122222222222222222222221