1p0111111111111111111111
100000000000000000000001
100000000000000000000001
100000000000000000000001
122200000000000000000001
100000000000000000000001
100000001000000000000001
100000000000000000000001
100000000000000000000001
100000000001000000000e01
100010000000222222222221
100000000000000000000001
100000001000000000000000
100000000000000000000003
100100000000000000002221
100000000001000000000001
100000000000000000000001
122222222222222222222221